   WE                            textures/wolfenstein/eagle.xpm
NO      textures/wolfenstein/grey_stone.xpm



SO textures/wolfenstein/red_brick.xpm

F   69, 222, 199

EA textures/wolfenstein/mossy.xpm



C 255, 198, 52

        1111111111111111111111111111
        100D000000110000000000000001
        1011000001110000000000000111
        10010000000000000000000011
111111111011000001110000000000001
1000000D001100000111D111111111111
11110111111111011100000010001
11110111111111011101010010001
11000000110101011100000010001
1000000000000000DD00E00010001
100000000000001011010100D0001
1100000111010101111101111000111
11110111 1110101 101111010001
11111111 1111111 111111111111