WE		textures/wolfenstein/wall_4.xpm
NO		textures/wolfenstein/wall_1.xpm
SO		textures/wolfenstein/wall_3.xpm

EA		textures/wolfenstein/wall_2.xpm
F	175, 175, 175


C	126, 190, 255


        1111111111111111111111111
        100D000000110000000000001
        1011000001110000000000001
        1001000000000000000000001
111111111011000001110000000000001
1000000D001100000111D111111111111
11110111111111011100000010001
11110111111111011101010010001
11000000110101011100000010001
1000000000000000DD00000010001
100000000000000011010100D0001
11000001110101011111011110N0111
11110111 1110101 101111010001
11111111 1111111 111111111111