   WE                            textures/wolfenstein/eagle.xpm
NO      textures/wolfenstein/grey_stone.xpm



SO textures/wolfenstein/red_brick.xpm

F   69, 222, 199

EA textures/wolfenstein/mossy.xpm



C 255, 198, 52

111111111111111111111111
1001000000000000000000011
10000000000000000000000001
100000000S0000000000000001
101D100000000000000000011
100000000000000000000001
100000000000000000000001
111000111110000101010001
   1000001000100000000001
111000100010000100010001
100000100010000000000001
100000111100001010100001
100000000000000000000001
100000000000001000000001
100000000000000001000001
10000000000000001 1000001
100000000000000001000001
100000000000000000000001
100000000000000000000001
111111111000000000000001
100100001000000000000001
100000101000000000000001
100100001000000000000001
10011111100001D100000001
100000000000000000000001
100000000000000000000001
111111111111111111111111