   11111
1PCE11   
  11111111  