 1111111
100011   
1111111111  